Polyphenol Name	Yield_thres_50_0	Yield_thres_50_1	Yield_thres_50_pred_AUC	Yield_thres_50_pred_J_thres	Yield_thres_50_pred_J_thres_acc	Yield_thres_50_pred_J_TN	Yield_thres_50_pred_J_FP	Yield_thres_50_pred_J_FN	Yield_thres_50_pred_J_TP
2',3'-Dihydroxy-4'-methoxyacetophenone	32	7	0.43303571428571425	0.5573433333333333	0.8205128205128205	32	0	7	0
2,3,4-Trihydroxybenzoic acid	39	0		0.5573433333333333	0.9230769230769231	36	3	0	0
2,4'-Dihydroxybenzophenone	35	4	0.42857142857142855	0.5573433333333333	0.8974358974358975	35	0	4	0
4'-Methoxyresveratrol	25	14	0.18	0.5573433333333333	0.6410256410256411	25	0	14	0
4,7-DIHYDROXYCOUMARIN	37	2	0.4054054054054054	0.5573433333333333	0.8461538461538461	33	4	2	0
4-Allylpyrocatechol	28	11	0.24025974025974026	0.5573433333333333	0.717948717948718	28	0	11	0
4-Methylesculetin	28	11	0.3311688311688311	0.5573433333333333	0.6153846153846154	24	4	11	0
4-Methyllimetol	21	18	0.2195767195767196	0.5573433333333333	0.48717948717948717	18	3	17	1
5,7-Dihydroxy-4-phenylcoumarin	31	8	0.2540322580645161	0.5573433333333333	0.7692307692307693	30	1	8	0
5,7-Dihydroxychromone	33	6	0.2676767676767676	0.5573433333333333	0.7948717948717948	30	3	5	1
6,7,4'-Trihydroxyisoflavone	29	10	0.6551724137931034	0.5573433333333333	0.717948717948718	24	5	6	4
6-Methoxyluteolin	25	14	0.4457142857142857	0.5573433333333333	0.6410256410256411	24	1	13	1
7,8-Dihydroxy-4-phenylcoumarin	33	6	0.3282828282828283	0.5573433333333333	0.8205128205128205	32	1	6	0
Apigenin	21	18	0.5158730158730158	0.5573433333333333	0.48717948717948717	14	7	13	5
Aromadendrin	35	4	0.5785714285714285	0.5573433333333333	0.8461538461538461	33	2	4	0
Atraric acid	31	8	0.43145161290322576	0.5573433333333333	0.7948717948717948	31	0	8	0
Aurantio-obtusin	33	6	0.5252525252525253	0.5573433333333333	0.8461538461538461	33	0	6	0
Bavachin	27	12	0.4660493827160494	0.5573433333333333	0.6923076923076923	27	0	12	0
Butein	19	20	0.42894736842105263	0.5573433333333333	0.5128205128205128	19	0	19	1
Caffeic Acid Phenethyl Ester	21	18	0.24603174603174605	0.5573433333333333	0.5384615384615384	21	0	18	0
Calycosin	31	8	0.4798387096774194	0.5573433333333333	0.7692307692307693	30	1	8	0
Dendrophenol	35	4	0.3	0.5573433333333333	0.8974358974358975	35	0	4	0
Equol	37	2	0.5405405405405406	0.5573433333333333	0.9487179487179487	37	0	2	0
Eriodictyol	31	8	0.4717741935483871	0.5573433333333333	0.7948717948717948	30	1	7	1
Flavokawain C	29	10	0.6551724137931034	0.5573433333333333	0.7435897435897436	29	0	10	0
Genistein	31	8	0.5564516129032258	0.5573433333333333	0.6923076923076923	23	8	4	4
Gnetol	30	9	0.45185185185185184	0.5573433333333333	0.7692307692307693	30	0	9	0
Hispidulin	19	20	0.5236842105263159	0.5573433333333333	0.48717948717948717	18	1	19	1
Homogentisic acid	37	2	0.41891891891891886	0.5573433333333333	0.9487179487179487	37	0	2	0
Hydroxytyrosol Acetate	32	7	0.21875	0.5573433333333333	0.8205128205128205	32	0	7	0
Irigenin	32	7	0.4508928571428571	0.5573433333333333	0.8205128205128205	32	0	7	0
Isorhapontigenin	29	10	0.36206896551724144	0.5573433333333333	0.7435897435897436	29	0	10	0
Jaceosidin	20	19	0.5394736842105263	0.5573433333333333	0.5384615384615384	20	0	18	1
Luteolin	20	19	0.47368421052631576	0.5573433333333333	0.46153846153846156	10	10	11	8
Mangiferin	39	0		0.5573433333333333	1.0	39	0	0	0
Methyl caffeate acid	27	12	0.2191358024691358	0.5573433333333333	0.6923076923076923	27	0	12	0
Neobavaisoflavone	21	18	0.5476190476190477	0.5573433333333333	0.5384615384615384	21	0	18	0
Neochlorogenic acid	39	0		0.5573433333333333	1.0	39	0	0	0
Nordihydroguaiaretic acid	33	6	0.46969696969696967	0.5573433333333333	0.8461538461538461	33	0	6	0
Oroxylin A	28	11	0.4155844155844155	0.5573433333333333	0.7435897435897436	28	0	10	1
Polydatin	39	0		0.5573433333333333	1.0	39	0	0	0
Propyl gallate	22	17	0.10962566844919784	0.5573433333333333	0.5641025641025641	22	0	17	0
Protosappanin B	39	0		0.5573433333333333	1.0	39	0	0	0
Rhapontigenin	25	14	0.2742857142857143	0.5573433333333333	0.6410256410256411	25	0	14	0
Sakuranetin	36	3	0.7592592592592592	0.5573433333333333	0.9230769230769231	36	0	3	0
Tectorigenin	37	2	0.5405405405405406	0.5573433333333333	0.9230769230769231	36	1	2	0
Vitexin	39	0		0.5573433333333333	1.0	39	0	0	0
